Dis,Terminal ID,Terminal,Time slot,Nb of releases,Nb of bike returns,Balance
Vilnius,1,1-ARKIKATEDRA,00H - 01H,186,126,-60
Vilnius,1,1-ARKIKATEDRA,01H - 02H,97,71,-26
Vilnius,1,1-ARKIKATEDRA,02H - 03H,54,16,-38
Vilnius,1,1-ARKIKATEDRA,03H - 04H,48,22,-26
Vilnius,1,1-ARKIKATEDRA,04H - 05H,40,13,-27
Vilnius,1,1-ARKIKATEDRA,05H - 06H,38,16,-22
Vilnius,1,1-ARKIKATEDRA,06H - 07H,618,101,-517
Vilnius,1,1-ARKIKATEDRA,07H - 08H,606,1010,404
Vilnius,1,1-ARKIKATEDRA,08H - 09H,1148,1751,603
Vilnius,1,1-ARKIKATEDRA,09H - 10H,970,939,-31
Vilnius,1,1-ARKIKATEDRA,10H - 11H,678,814,136
Vilnius,1,1-ARKIKATEDRA,11H - 12H,776,876,100
Vilnius,1,1-ARKIKATEDRA,12H - 13H,1072,1105,33
Vilnius,1,1-ARKIKATEDRA,13H - 14H,825,967,142
Vilnius,1,1-ARKIKATEDRA,14H - 15H,1005,895,-110
Vilnius,1,1-ARKIKATEDRA,15H - 16H,988,955,-33
Vilnius,1,1-ARKIKATEDRA,16H - 17H,1323,1085,-238
Vilnius,1,1-ARKIKATEDRA,17H - 18H,1614,1367,-247
Vilnius,1,1-ARKIKATEDRA,18H - 19H,1414,1616,202
Vilnius,1,1-ARKIKATEDRA,19H - 20H,1216,1230,14
Vilnius,1,1-ARKIKATEDRA,20H - 21H,975,961,-14
Vilnius,1,1-ARKIKATEDRA,21H - 22H,708,641,-67
Vilnius,1,1-ARKIKATEDRA,22H - 23H,490,381,-109
Vilnius,1,1-ARKIKATEDRA,23H - 24H,304,238,-66
Vilnius,2,2-BARBOROS RADVILAITES,00H - 01H,134,122,-12
Vilnius,2,2-BARBOROS RADVILAITES,01H - 02H,67,77,10
Vilnius,2,2-BARBOROS RADVILAITES,02H - 03H,38,45,7
Vilnius,2,2-BARBOROS RADVILAITES,03H - 04H,16,29,13
Vilnius,2,2-BARBOROS RADVILAITES,04H - 05H,19,25,6
Vilnius,2,2-BARBOROS RADVILAITES,05H - 06H,21,19,-2
Vilnius,2,2-BARBOROS RADVILAITES,06H - 07H,820,79,-741
Vilnius,2,2-BARBOROS RADVILAITES,07H - 08H,985,1537,552
Vilnius,2,2-BARBOROS RADVILAITES,08H - 09H,1641,1693,52
Vilnius,2,2-BARBOROS RADVILAITES,09H - 10H,1116,1050,-66
Vilnius,2,2-BARBOROS RADVILAITES,10H - 11H,647,762,115
Vilnius,2,2-BARBOROS RADVILAITES,11H - 12H,933,731,-202
Vilnius,2,2-BARBOROS RADVILAITES,12H - 13H,958,1111,153
Vilnius,2,2-BARBOROS RADVILAITES,13H - 14H,929,1132,203
Vilnius,2,2-BARBOROS RADVILAITES,14H - 15H,818,895,77
Vilnius,2,2-BARBOROS RADVILAITES,15H - 16H,1078,1065,-13
Vilnius,2,2-BARBOROS RADVILAITES,16H - 17H,1396,1035,-361
Vilnius,2,2-BARBOROS RADVILAITES,17H - 18H,1707,1377,-330
Vilnius,2,2-BARBOROS RADVILAITES,18H - 19H,1140,1494,354
Vilnius,2,2-BARBOROS RADVILAITES,19H - 20H,1040,1076,36
Vilnius,2,2-BARBOROS RADVILAITES,20H - 21H,884,1013,129
Vilnius,2,2-BARBOROS RADVILAITES,21H - 22H,659,754,95
Vilnius,2,2-BARBOROS RADVILAITES,22H - 23H,406,387,-19
Vilnius,2,2-BARBOROS RADVILAITES,23H - 24H,220,173,-47
Vilnius,3,3-K. SIRVYDO SKV.,00H - 01H,115,82,-33
Vilnius,3,3-K. SIRVYDO SKV.,01H - 02H,83,47,-36
Vilnius,3,3-K. SIRVYDO SKV.,02H - 03H,56,33,-23
Vilnius,3,3-K. SIRVYDO SKV.,03H - 04H,28,25,-3
Vilnius,3,3-K. SIRVYDO SKV.,04H - 05H,23,15,-8
Vilnius,3,3-K. SIRVYDO SKV.,05H - 06H,17,21,4
Vilnius,3,3-K. SIRVYDO SKV.,06H - 07H,96,78,-18
Vilnius,3,3-K. SIRVYDO SKV.,07H - 08H,431,276,-155
Vilnius,3,3-K. SIRVYDO SKV.,08H - 09H,379,626,247
Vilnius,3,3-K. SIRVYDO SKV.,09H - 10H,375,413,38
Vilnius,3,3-K. SIRVYDO SKV.,10H - 11H,240,376,136
Vilnius,3,3-K. SIRVYDO SKV.,11H - 12H,304,373,69
Vilnius,3,3-K. SIRVYDO SKV.,12H - 13H,546,453,-93
Vilnius,3,3-K. SIRVYDO SKV.,13H - 14H,455,513,58
Vilnius,3,3-K. SIRVYDO SKV.,14H - 15H,474,460,-14
Vilnius,3,3-K. SIRVYDO SKV.,15H - 16H,545,439,-106
Vilnius,3,3-K. SIRVYDO SKV.,16H - 17H,652,555,-97
Vilnius,3,3-K. SIRVYDO SKV.,17H - 18H,677,605,-72
Vilnius,3,3-K. SIRVYDO SKV.,18H - 19H,625,724,99
Vilnius,3,3-K. SIRVYDO SKV.,19H - 20H,519,600,81
Vilnius,3,3-K. SIRVYDO SKV.,20H - 21H,505,498,-7
Vilnius,3,3-K. SIRVYDO SKV.,21H - 22H,334,379,45
Vilnius,3,3-K. SIRVYDO SKV.,22H - 23H,282,232,-50
Vilnius,3,3-K. SIRVYDO SKV.,23H - 24H,200,144,-56
Vilnius,4,4-ŠV. KAZIMIERO BAŽNYCIA,00H - 01H,196,138,-58
Vilnius,4,4-ŠV. KAZIMIERO BAŽNYCIA,01H - 02H,117,61,-56
Vilnius,4,4-ŠV. KAZIMIERO BAŽNYCIA,02H - 03H,89,52,-37
Vilnius,4,4-ŠV. KAZIMIERO BAŽNYCIA,03H - 04H,62,29,-33
Vilnius,4,4-ŠV. KAZIMIERO BAŽNYCIA,04H - 05H,54,25,-29
Vilnius,4,4-ŠV. KAZIMIERO BAŽNYCIA,05H - 06H,27,19,-8
Vilnius,4,4-ŠV. KAZIMIERO BAŽNYCIA,06H - 07H,54,96,42
Vilnius,4,4-ŠV. KAZIMIERO BAŽNYCIA,07H - 08H,224,327,103
Vilnius,4,4-ŠV. KAZIMIERO BAŽNYCIA,08H - 09H,818,580,-238
Vilnius,4,4-ŠV. KAZIMIERO BAŽNYCIA,09H - 10H,754,765,11
Vilnius,4,4-ŠV. KAZIMIERO BAŽNYCIA,10H - 11H,385,533,148
Vilnius,4,4-ŠV. KAZIMIERO BAŽNYCIA,11H - 12H,469,445,-24
Vilnius,4,4-ŠV. KAZIMIERO BAŽNYCIA,12H - 13H,638,666,28
Vilnius,4,4-ŠV. KAZIMIERO BAŽNYCIA,13H - 14H,618,641,23
Vilnius,4,4-ŠV. KAZIMIERO BAŽNYCIA,14H - 15H,602,542,-60
Vilnius,4,4-ŠV. KAZIMIERO BAŽNYCIA,15H - 16H,669,532,-137
Vilnius,4,4-ŠV. KAZIMIERO BAŽNYCIA,16H - 17H,749,725,-24
Vilnius,4,4-ŠV. KAZIMIERO BAŽNYCIA,17H - 18H,774,933,159
Vilnius,4,4-ŠV. KAZIMIERO BAŽNYCIA,18H - 19H,911,1093,182
Vilnius,4,4-ŠV. KAZIMIERO BAŽNYCIA,19H - 20H,725,789,64
Vilnius,4,4-ŠV. KAZIMIERO BAŽNYCIA,20H - 21H,688,718,30
Vilnius,4,4-ŠV. KAZIMIERO BAŽNYCIA,21H - 22H,533,544,11
Vilnius,4,4-ŠV. KAZIMIERO BAŽNYCIA,22H - 23H,394,373,-21
Vilnius,4,4-ŠV. KAZIMIERO BAŽNYCIA,23H - 24H,262,184,-78
Vilnius,5,5-FILHARMONIJA,00H - 01H,102,57,-45
Vilnius,5,5-FILHARMONIJA,01H - 02H,74,42,-32
Vilnius,5,5-FILHARMONIJA,02H - 03H,26,19,-7
Vilnius,5,5-FILHARMONIJA,03H - 04H,18,17,-1
Vilnius,5,5-FILHARMONIJA,04H - 05H,8,8,0
Vilnius,5,5-FILHARMONIJA,05H - 06H,4,9,5
Vilnius,5,5-FILHARMONIJA,06H - 07H,22,284,262
Vilnius,5,5-FILHARMONIJA,07H - 08H,213,321,108
Vilnius,5,5-FILHARMONIJA,08H - 09H,705,292,-413
Vilnius,5,5-FILHARMONIJA,09H - 10H,555,530,-25
Vilnius,5,5-FILHARMONIJA,10H - 11H,218,230,12
Vilnius,5,5-FILHARMONIJA,11H - 12H,283,239,-44
Vilnius,5,5-FILHARMONIJA,12H - 13H,359,354,-5
Vilnius,5,5-FILHARMONIJA,13H - 14H,301,248,-53
Vilnius,5,5-FILHARMONIJA,14H - 15H,304,266,-38
Vilnius,5,5-FILHARMONIJA,15H - 16H,279,285,6
Vilnius,5,5-FILHARMONIJA,16H - 17H,240,281,41
Vilnius,5,5-FILHARMONIJA,17H - 18H,401,454,53
Vilnius,5,5-FILHARMONIJA,18H - 19H,413,500,87
Vilnius,5,5-FILHARMONIJA,19H - 20H,425,440,15
Vilnius,5,5-FILHARMONIJA,20H - 21H,366,383,17
Vilnius,5,5-FILHARMONIJA,21H - 22H,238,270,32
Vilnius,5,5-FILHARMONIJA,22H - 23H,165,228,63
Vilnius,5,5-FILHARMONIJA,23H - 24H,153,119,-34
Vilnius,6,6-HALES TURGAVIETE,00H - 01H,72,68,-4
Vilnius,6,6-HALES TURGAVIETE,01H - 02H,42,46,4
Vilnius,6,6-HALES TURGAVIETE,02H - 03H,34,36,2
Vilnius,6,6-HALES TURGAVIETE,03H - 04H,14,21,7
Vilnius,6,6-HALES TURGAVIETE,04H - 05H,8,16,8
Vilnius,6,6-HALES TURGAVIETE,05H - 06H,12,6,-6
Vilnius,6,6-HALES TURGAVIETE,06H - 07H,40,160,120
Vilnius,6,6-HALES TURGAVIETE,07H - 08H,429,262,-167
Vilnius,6,6-HALES TURGAVIETE,08H - 09H,684,601,-83
Vilnius,6,6-HALES TURGAVIETE,09H - 10H,443,392,-51
Vilnius,6,6-HALES TURGAVIETE,10H - 11H,392,325,-67
Vilnius,6,6-HALES TURGAVIETE,11H - 12H,424,431,7
Vilnius,6,6-HALES TURGAVIETE,12H - 13H,443,523,80
Vilnius,6,6-HALES TURGAVIETE,13H - 14H,437,437,0
Vilnius,6,6-HALES TURGAVIETE,14H - 15H,416,318,-98
Vilnius,6,6-HALES TURGAVIETE,15H - 16H,367,365,-2
Vilnius,6,6-HALES TURGAVIETE,16H - 17H,416,412,-4
Vilnius,6,6-HALES TURGAVIETE,17H - 18H,488,632,144
Vilnius,6,6-HALES TURGAVIETE,18H - 19H,558,608,50
Vilnius,6,6-HALES TURGAVIETE,19H - 20H,485,448,-37
Vilnius,6,6-HALES TURGAVIETE,20H - 21H,374,379,5
Vilnius,6,6-HALES TURGAVIETE,21H - 22H,264,290,26
Vilnius,6,6-HALES TURGAVIETE,22H - 23H,175,242,67
Vilnius,6,6-HALES TURGAVIETE,23H - 24H,130,131,1
Vilnius,7,7-STOTIS,00H - 01H,11,13,2
Vilnius,7,7-STOTIS,01H - 02H,11,8,-3
Vilnius,7,7-STOTIS,02H - 03H,8,5,-3
Vilnius,7,7-STOTIS,03H - 04H,5,7,2
Vilnius,7,7-STOTIS,04H - 05H,2,3,1
Vilnius,7,7-STOTIS,05H - 06H,0,4,4
Vilnius,7,7-STOTIS,06H - 07H,29,356,327
Vilnius,7,7-STOTIS,07H - 08H,410,238,-172
Vilnius,7,7-STOTIS,08H - 09H,229,257,28
Vilnius,7,7-STOTIS,09H - 10H,176,173,-3
Vilnius,7,7-STOTIS,10H - 11H,100,172,72
Vilnius,7,7-STOTIS,11H - 12H,104,122,18
Vilnius,7,7-STOTIS,12H - 13H,125,112,-13
Vilnius,7,7-STOTIS,13H - 14H,127,101,-26
Vilnius,7,7-STOTIS,14H - 15H,119,114,-5
Vilnius,7,7-STOTIS,15H - 16H,147,126,-21
Vilnius,7,7-STOTIS,16H - 17H,208,141,-67
Vilnius,7,7-STOTIS,17H - 18H,222,232,10
Vilnius,7,7-STOTIS,18H - 19H,266,255,-11
Vilnius,7,7-STOTIS,19H - 20H,193,163,-30
Vilnius,7,7-STOTIS,20H - 21H,188,147,-41
Vilnius,7,7-STOTIS,21H - 22H,121,105,-16
Vilnius,7,7-STOTIS,22H - 23H,83,48,-35
Vilnius,7,7-STOTIS,23H - 24H,47,21,-26
Vilnius,8,8-MAIRONIO G.,00H - 01H,32,60,28
Vilnius,8,8-MAIRONIO G.,01H - 02H,26,33,7
Vilnius,8,8-MAIRONIO G.,02H - 03H,3,17,14
Vilnius,8,8-MAIRONIO G.,03H - 04H,5,15,10
Vilnius,8,8-MAIRONIO G.,04H - 05H,5,8,3
Vilnius,8,8-MAIRONIO G.,05H - 06H,1,23,22
Vilnius,8,8-MAIRONIO G.,06H - 07H,108,14,-94
Vilnius,8,8-MAIRONIO G.,07H - 08H,290,49,-241
Vilnius,8,8-MAIRONIO G.,08H - 09H,552,253,-299
Vilnius,8,8-MAIRONIO G.,09H - 10H,317,257,-60
Vilnius,8,8-MAIRONIO G.,10H - 11H,176,200,24
Vilnius,8,8-MAIRONIO G.,11H - 12H,190,190,0
Vilnius,8,8-MAIRONIO G.,12H - 13H,274,296,22
Vilnius,8,8-MAIRONIO G.,13H - 14H,266,239,-27
Vilnius,8,8-MAIRONIO G.,14H - 15H,354,258,-96
Vilnius,8,8-MAIRONIO G.,15H - 16H,325,324,-1
Vilnius,8,8-MAIRONIO G.,16H - 17H,385,394,9
Vilnius,8,8-MAIRONIO G.,17H - 18H,335,550,215
Vilnius,8,8-MAIRONIO G.,18H - 19H,493,644,151
Vilnius,8,8-MAIRONIO G.,19H - 20H,506,539,33
Vilnius,8,8-MAIRONIO G.,20H - 21H,393,432,39
Vilnius,8,8-MAIRONIO G.,21H - 22H,189,311,122
Vilnius,8,8-MAIRONIO G.,22H - 23H,117,184,67
Vilnius,8,8-MAIRONIO G.,23H - 24H,62,125,63
Vilnius,9,9-UŽUPIS,00H - 01H,38,76,38
Vilnius,9,9-UŽUPIS,01H - 02H,15,43,28
Vilnius,9,9-UŽUPIS,02H - 03H,9,31,22
Vilnius,9,9-UŽUPIS,03H - 04H,4,16,12
Vilnius,9,9-UŽUPIS,04H - 05H,4,20,16
Vilnius,9,9-UŽUPIS,05H - 06H,5,10,5
Vilnius,9,9-UŽUPIS,06H - 07H,53,201,148
Vilnius,9,9-UŽUPIS,07H - 08H,490,233,-257
Vilnius,9,9-UŽUPIS,08H - 09H,768,518,-250
Vilnius,9,9-UŽUPIS,09H - 10H,499,469,-30
Vilnius,9,9-UŽUPIS,10H - 11H,228,271,43
Vilnius,9,9-UŽUPIS,11H - 12H,238,198,-40
Vilnius,9,9-UŽUPIS,12H - 13H,263,264,1
Vilnius,9,9-UŽUPIS,13H - 14H,271,264,-7
Vilnius,9,9-UŽUPIS,14H - 15H,304,252,-52
Vilnius,9,9-UŽUPIS,15H - 16H,330,295,-35
Vilnius,9,9-UŽUPIS,16H - 17H,299,302,3
Vilnius,9,9-UŽUPIS,17H - 18H,363,465,102
Vilnius,9,9-UŽUPIS,18H - 19H,457,462,5
Vilnius,9,9-UŽUPIS,19H - 20H,387,383,-4
Vilnius,9,9-UŽUPIS,20H - 21H,354,381,27
Vilnius,9,9-UŽUPIS,21H - 22H,201,268,67
Vilnius,9,9-UŽUPIS,22H - 23H,102,198,96
Vilnius,9,9-UŽUPIS,23H - 24H,61,120,59
Vilnius,10,10-KALNU PARKAS,00H - 01H,16,39,23
Vilnius,10,10-KALNU PARKAS,01H - 02H,6,16,10
Vilnius,10,10-KALNU PARKAS,02H - 03H,4,18,14
Vilnius,10,10-KALNU PARKAS,03H - 04H,4,7,3
Vilnius,10,10-KALNU PARKAS,04H - 05H,6,9,3
Vilnius,10,10-KALNU PARKAS,05H - 06H,3,6,3
Vilnius,10,10-KALNU PARKAS,06H - 07H,44,154,110
Vilnius,10,10-KALNU PARKAS,07H - 08H,659,256,-403
Vilnius,10,10-KALNU PARKAS,08H - 09H,740,553,-187
Vilnius,10,10-KALNU PARKAS,09H - 10H,332,455,123
Vilnius,10,10-KALNU PARKAS,10H - 11H,267,338,71
Vilnius,10,10-KALNU PARKAS,11H - 12H,197,261,64
Vilnius,10,10-KALNU PARKAS,12H - 13H,319,351,32
Vilnius,10,10-KALNU PARKAS,13H - 14H,256,265,9
Vilnius,10,10-KALNU PARKAS,14H - 15H,430,291,-139
Vilnius,10,10-KALNU PARKAS,15H - 16H,422,392,-30
Vilnius,10,10-KALNU PARKAS,16H - 17H,528,629,101
Vilnius,10,10-KALNU PARKAS,17H - 18H,582,705,123
Vilnius,10,10-KALNU PARKAS,18H - 19H,481,467,-14
Vilnius,10,10-KALNU PARKAS,19H - 20H,387,358,-29
Vilnius,10,10-KALNU PARKAS,20H - 21H,299,322,23
Vilnius,10,10-KALNU PARKAS,21H - 22H,166,221,55
Vilnius,10,10-KALNU PARKAS,22H - 23H,91,115,24
Vilnius,10,10-KALNU PARKAS,23H - 24H,49,57,8
Vilnius,11,11-KARALIAUS MINDAUGO,00H - 01H,51,40,-11
Vilnius,11,11-KARALIAUS MINDAUGO,01H - 02H,21,16,-5
Vilnius,11,11-KARALIAUS MINDAUGO,02H - 03H,11,13,2
Vilnius,11,11-KARALIAUS MINDAUGO,03H - 04H,5,8,3
Vilnius,11,11-KARALIAUS MINDAUGO,04H - 05H,12,10,-2
Vilnius,11,11-KARALIAUS MINDAUGO,05H - 06H,13,15,2
Vilnius,11,11-KARALIAUS MINDAUGO,06H - 07H,137,81,-56
Vilnius,11,11-KARALIAUS MINDAUGO,07H - 08H,280,361,81
Vilnius,11,11-KARALIAUS MINDAUGO,08H - 09H,430,429,-1
Vilnius,11,11-KARALIAUS MINDAUGO,09H - 10H,394,434,40
Vilnius,11,11-KARALIAUS MINDAUGO,10H - 11H,235,159,-76
Vilnius,11,11-KARALIAUS MINDAUGO,11H - 12H,231,199,-32
Vilnius,11,11-KARALIAUS MINDAUGO,12H - 13H,297,320,23
Vilnius,11,11-KARALIAUS MINDAUGO,13H - 14H,206,258,52
Vilnius,11,11-KARALIAUS MINDAUGO,14H - 15H,231,242,11
Vilnius,11,11-KARALIAUS MINDAUGO,15H - 16H,268,259,-9
Vilnius,11,11-KARALIAUS MINDAUGO,16H - 17H,326,236,-90
Vilnius,11,11-KARALIAUS MINDAUGO,17H - 18H,497,432,-65
Vilnius,11,11-KARALIAUS MINDAUGO,18H - 19H,560,477,-83
Vilnius,11,11-KARALIAUS MINDAUGO,19H - 20H,364,438,74
Vilnius,11,11-KARALIAUS MINDAUGO,20H - 21H,258,321,63
Vilnius,11,11-KARALIAUS MINDAUGO,21H - 22H,210,282,72
Vilnius,11,11-KARALIAUS MINDAUGO,22H - 23H,149,160,11
Vilnius,11,11-KARALIAUS MINDAUGO,23H - 24H,75,66,-9
Vilnius,12,12-V. KUDIRKOS A.,00H - 01H,306,175,-131
Vilnius,12,12-V. KUDIRKOS A.,01H - 02H,225,126,-99
Vilnius,12,12-V. KUDIRKOS A.,02H - 03H,165,74,-91
Vilnius,12,12-V. KUDIRKOS A.,03H - 04H,84,38,-46
Vilnius,12,12-V. KUDIRKOS A.,04H - 05H,59,25,-34
Vilnius,12,12-V. KUDIRKOS A.,05H - 06H,33,17,-16
Vilnius,12,12-V. KUDIRKOS A.,06H - 07H,246,114,-132
Vilnius,12,12-V. KUDIRKOS A.,07H - 08H,442,872,430
Vilnius,12,12-V. KUDIRKOS A.,08H - 09H,1804,2585,781
Vilnius,12,12-V. KUDIRKOS A.,09H - 10H,1641,1692,51
Vilnius,12,12-V. KUDIRKOS A.,10H - 11H,1028,994,-34
Vilnius,12,12-V. KUDIRKOS A.,11H - 12H,1183,1283,100
Vilnius,12,12-V. KUDIRKOS A.,12H - 13H,2018,1744,-274
Vilnius,12,12-V. KUDIRKOS A.,13H - 14H,1538,1631,93
Vilnius,12,12-V. KUDIRKOS A.,14H - 15H,1441,1524,83
Vilnius,12,12-V. KUDIRKOS A.,15H - 16H,1421,1403,-18
Vilnius,12,12-V. KUDIRKOS A.,16H - 17H,1637,1640,3
Vilnius,12,12-V. KUDIRKOS A.,17H - 18H,2768,2405,-363
Vilnius,12,12-V. KUDIRKOS A.,18H - 19H,2506,2449,-57
Vilnius,12,12-V. KUDIRKOS A.,19H - 20H,1655,1689,34
Vilnius,12,12-V. KUDIRKOS A.,20H - 21H,1275,1399,124
Vilnius,12,12-V. KUDIRKOS A.,21H - 22H,1116,988,-128
Vilnius,12,12-V. KUDIRKOS A.,22H - 23H,757,539,-218
Vilnius,12,12-V. KUDIRKOS A.,23H - 24H,415,351,-64
Vilnius,13,13-A. VIENUOLIO,00H - 01H,143,81,-62
Vilnius,13,13-A. VIENUOLIO,01H - 02H,101,44,-57
Vilnius,13,13-A. VIENUOLIO,02H - 03H,59,45,-14
Vilnius,13,13-A. VIENUOLIO,03H - 04H,62,31,-31
Vilnius,13,13-A. VIENUOLIO,04H - 05H,28,31,3
Vilnius,13,13-A. VIENUOLIO,05H - 06H,30,18,-12
Vilnius,13,13-A. VIENUOLIO,06H - 07H,349,122,-227
Vilnius,13,13-A. VIENUOLIO,07H - 08H,360,569,209
Vilnius,13,13-A. VIENUOLIO,08H - 09H,687,1356,669
Vilnius,13,13-A. VIENUOLIO,09H - 10H,1010,1114,104
Vilnius,13,13-A. VIENUOLIO,10H - 11H,705,626,-79
Vilnius,13,13-A. VIENUOLIO,11H - 12H,665,696,31
Vilnius,13,13-A. VIENUOLIO,12H - 13H,939,893,-46
Vilnius,13,13-A. VIENUOLIO,13H - 14H,724,709,-15
Vilnius,13,13-A. VIENUOLIO,14H - 15H,686,650,-36
Vilnius,13,13-A. VIENUOLIO,15H - 16H,701,658,-43
Vilnius,13,13-A. VIENUOLIO,16H - 17H,939,844,-95
Vilnius,13,13-A. VIENUOLIO,17H - 18H,1380,1166,-214
Vilnius,13,13-A. VIENUOLIO,18H - 19H,1160,1256,96
Vilnius,13,13-A. VIENUOLIO,19H - 20H,802,1003,201
Vilnius,13,13-A. VIENUOLIO,20H - 21H,669,592,-77
Vilnius,13,13-A. VIENUOLIO,21H - 22H,563,461,-102
Vilnius,13,13-A. VIENUOLIO,22H - 23H,380,242,-138
Vilnius,13,13-A. VIENUOLIO,23H - 24H,218,146,-72
Vilnius,14,14-LUKIŠKIU A.,00H - 01H,120,130,10
Vilnius,14,14-LUKIŠKIU A.,01H - 02H,68,76,8
Vilnius,14,14-LUKIŠKIU A.,02H - 03H,53,42,-11
Vilnius,14,14-LUKIŠKIU A.,03H - 04H,30,39,9
Vilnius,14,14-LUKIŠKIU A.,04H - 05H,21,23,2
Vilnius,14,14-LUKIŠKIU A.,05H - 06H,16,9,-7
Vilnius,14,14-LUKIŠKIU A.,06H - 07H,238,158,-80
Vilnius,14,14-LUKIŠKIU A.,07H - 08H,505,746,241
Vilnius,14,14-LUKIŠKIU A.,08H - 09H,1133,1441,308
Vilnius,14,14-LUKIŠKIU A.,09H - 10H,886,853,-33
Vilnius,14,14-LUKIŠKIU A.,10H - 11H,652,608,-44
Vilnius,14,14-LUKIŠKIU A.,11H - 12H,978,752,-226
Vilnius,14,14-LUKIŠKIU A.,12H - 13H,1155,1232,77
Vilnius,14,14-LUKIŠKIU A.,13H - 14H,934,1020,86
Vilnius,14,14-LUKIŠKIU A.,14H - 15H,917,835,-82
Vilnius,14,14-LUKIŠKIU A.,15H - 16H,985,928,-57
Vilnius,14,14-LUKIŠKIU A.,16H - 17H,1303,1113,-190
Vilnius,14,14-LUKIŠKIU A.,17H - 18H,1914,1556,-358
Vilnius,14,14-LUKIŠKIU A.,18H - 19H,1308,1420,112
Vilnius,14,14-LUKIŠKIU A.,19H - 20H,1069,1123,54
Vilnius,14,14-LUKIŠKIU A.,20H - 21H,779,871,92
Vilnius,14,14-LUKIŠKIU A.,21H - 22H,659,643,-16
Vilnius,14,14-LUKIŠKIU A.,22H - 23H,406,488,82
Vilnius,14,14-LUKIŠKIU A.,23H - 24H,223,254,31
Vilnius,15,15-M. MAŽVYDO BIBLIOTEKA,00H - 01H,83,233,150
Vilnius,15,15-M. MAŽVYDO BIBLIOTEKA,01H - 02H,44,141,97
Vilnius,15,15-M. MAŽVYDO BIBLIOTEKA,02H - 03H,26,92,66
Vilnius,15,15-M. MAŽVYDO BIBLIOTEKA,03H - 04H,29,58,29
Vilnius,15,15-M. MAŽVYDO BIBLIOTEKA,04H - 05H,7,36,29
Vilnius,15,15-M. MAŽVYDO BIBLIOTEKA,05H - 06H,4,37,33
Vilnius,15,15-M. MAŽVYDO BIBLIOTEKA,06H - 07H,716,79,-637
Vilnius,15,15-M. MAŽVYDO BIBLIOTEKA,07H - 08H,832,802,-30
Vilnius,15,15-M. MAŽVYDO BIBLIOTEKA,08H - 09H,1448,1413,-35
Vilnius,15,15-M. MAŽVYDO BIBLIOTEKA,09H - 10H,918,1380,462
Vilnius,15,15-M. MAŽVYDO BIBLIOTEKA,10H - 11H,625,531,-94
Vilnius,15,15-M. MAŽVYDO BIBLIOTEKA,11H - 12H,762,550,-212
Vilnius,15,15-M. MAŽVYDO BIBLIOTEKA,12H - 13H,926,968,42
Vilnius,15,15-M. MAŽVYDO BIBLIOTEKA,13H - 14H,802,939,137
Vilnius,15,15-M. MAŽVYDO BIBLIOTEKA,14H - 15H,744,729,-15
Vilnius,15,15-M. MAŽVYDO BIBLIOTEKA,15H - 16H,708,715,7
Vilnius,15,15-M. MAŽVYDO BIBLIOTEKA,16H - 17H,1166,908,-258
Vilnius,15,15-M. MAŽVYDO BIBLIOTEKA,17H - 18H,1686,1304,-382
Vilnius,15,15-M. MAŽVYDO BIBLIOTEKA,18H - 19H,1558,1394,-164
Vilnius,15,15-M. MAŽVYDO BIBLIOTEKA,19H - 20H,1029,1157,128
Vilnius,15,15-M. MAŽVYDO BIBLIOTEKA,20H - 21H,786,859,73
Vilnius,15,15-M. MAŽVYDO BIBLIOTEKA,21H - 22H,461,649,188
Vilnius,15,15-M. MAŽVYDO BIBLIOTEKA,22H - 23H,281,498,217
Vilnius,15,15-M. MAŽVYDO BIBLIOTEKA,23H - 24H,157,330,173
Vilnius,16,16-TAURO KALNAS,00H - 01H,41,52,11
Vilnius,16,16-TAURO KALNAS,01H - 02H,20,37,17
Vilnius,16,16-TAURO KALNAS,02H - 03H,13,26,13
Vilnius,16,16-TAURO KALNAS,03H - 04H,8,15,7
Vilnius,16,16-TAURO KALNAS,04H - 05H,6,6,0
Vilnius,16,16-TAURO KALNAS,05H - 06H,3,11,8
Vilnius,16,16-TAURO KALNAS,06H - 07H,152,79,-73
Vilnius,16,16-TAURO KALNAS,07H - 08H,285,554,269
Vilnius,16,16-TAURO KALNAS,08H - 09H,572,782,210
Vilnius,16,16-TAURO KALNAS,09H - 10H,389,357,-32
Vilnius,16,16-TAURO KALNAS,10H - 11H,281,181,-100
Vilnius,16,16-TAURO KALNAS,11H - 12H,373,211,-162
Vilnius,16,16-TAURO KALNAS,12H - 13H,452,454,2
Vilnius,16,16-TAURO KALNAS,13H - 14H,259,343,84
Vilnius,16,16-TAURO KALNAS,14H - 15H,229,294,65
Vilnius,16,16-TAURO KALNAS,15H - 16H,393,362,-31
Vilnius,16,16-TAURO KALNAS,16H - 17H,815,414,-401
Vilnius,16,16-TAURO KALNAS,17H - 18H,602,563,-39
Vilnius,16,16-TAURO KALNAS,18H - 19H,400,454,54
Vilnius,16,16-TAURO KALNAS,19H - 20H,298,350,52
Vilnius,16,16-TAURO KALNAS,20H - 21H,264,315,51
Vilnius,16,16-TAURO KALNAS,21H - 22H,196,200,4
Vilnius,16,16-TAURO KALNAS,22H - 23H,145,127,-18
Vilnius,16,16-TAURO KALNAS,23H - 24H,86,94,8
Vilnius,17,17-P. CVIRKOS,00H - 01H,132,72,-60
Vilnius,17,17-P. CVIRKOS,01H - 02H,79,56,-23
Vilnius,17,17-P. CVIRKOS,02H - 03H,70,32,-38
Vilnius,17,17-P. CVIRKOS,03H - 04H,62,24,-38
Vilnius,17,17-P. CVIRKOS,04H - 05H,52,12,-40
Vilnius,17,17-P. CVIRKOS,05H - 06H,32,6,-26
Vilnius,17,17-P. CVIRKOS,06H - 07H,68,76,8
Vilnius,17,17-P. CVIRKOS,07H - 08H,269,486,217
Vilnius,17,17-P. CVIRKOS,08H - 09H,445,626,181
Vilnius,17,17-P. CVIRKOS,09H - 10H,319,592,273
Vilnius,17,17-P. CVIRKOS,10H - 11H,209,286,77
Vilnius,17,17-P. CVIRKOS,11H - 12H,295,408,113
Vilnius,17,17-P. CVIRKOS,12H - 13H,485,407,-78
Vilnius,17,17-P. CVIRKOS,13H - 14H,389,362,-27
Vilnius,17,17-P. CVIRKOS,14H - 15H,297,327,30
Vilnius,17,17-P. CVIRKOS,15H - 16H,292,330,38
Vilnius,17,17-P. CVIRKOS,16H - 17H,489,422,-67
Vilnius,17,17-P. CVIRKOS,17H - 18H,916,510,-406
Vilnius,17,17-P. CVIRKOS,18H - 19H,615,518,-97
Vilnius,17,17-P. CVIRKOS,19H - 20H,463,409,-54
Vilnius,17,17-P. CVIRKOS,20H - 21H,318,349,31
Vilnius,17,17-P. CVIRKOS,21H - 22H,244,284,40
Vilnius,17,17-P. CVIRKOS,22H - 23H,184,200,16
Vilnius,17,17-P. CVIRKOS,23H - 24H,177,108,-69
Vilnius,18,18-VILNIAUS G.,00H - 01H,271,95,-176
Vilnius,18,18-VILNIAUS G.,01H - 02H,158,69,-89
Vilnius,18,18-VILNIAUS G.,02H - 03H,83,52,-31
Vilnius,18,18-VILNIAUS G.,03H - 04H,66,27,-39
Vilnius,18,18-VILNIAUS G.,04H - 05H,48,20,-28
Vilnius,18,18-VILNIAUS G.,05H - 06H,22,5,-17
Vilnius,18,18-VILNIAUS G.,06H - 07H,97,106,9
Vilnius,18,18-VILNIAUS G.,07H - 08H,223,362,139
Vilnius,18,18-VILNIAUS G.,08H - 09H,412,569,157
Vilnius,18,18-VILNIAUS G.,09H - 10H,363,668,305
Vilnius,18,18-VILNIAUS G.,10H - 11H,217,333,116
Vilnius,18,18-VILNIAUS G.,11H - 12H,307,414,107
Vilnius,18,18-VILNIAUS G.,12H - 13H,623,616,-7
Vilnius,18,18-VILNIAUS G.,13H - 14H,542,489,-53
Vilnius,18,18-VILNIAUS G.,14H - 15H,426,442,16
Vilnius,18,18-VILNIAUS G.,15H - 16H,509,449,-60
Vilnius,18,18-VILNIAUS G.,16H - 17H,554,520,-34
Vilnius,18,18-VILNIAUS G.,17H - 18H,898,688,-210
Vilnius,18,18-VILNIAUS G.,18H - 19H,825,779,-46
Vilnius,18,18-VILNIAUS G.,19H - 20H,560,651,91
Vilnius,18,18-VILNIAUS G.,20H - 21H,521,551,30
Vilnius,18,18-VILNIAUS G.,21H - 22H,494,482,-12
Vilnius,18,18-VILNIAUS G.,22H - 23H,372,332,-40
Vilnius,18,18-VILNIAUS G.,23H - 24H,336,199,-137
Vilnius,19,19-S. NERIES GIMNAZIJA,00H - 01H,201,116,-85
Vilnius,19,19-S. NERIES GIMNAZIJA,01H - 02H,161,69,-92
Vilnius,19,19-S. NERIES GIMNAZIJA,02H - 03H,101,36,-65
Vilnius,19,19-S. NERIES GIMNAZIJA,03H - 04H,75,20,-55
Vilnius,19,19-S. NERIES GIMNAZIJA,04H - 05H,54,10,-44
Vilnius,19,19-S. NERIES GIMNAZIJA,05H - 06H,49,5,-44
Vilnius,19,19-S. NERIES GIMNAZIJA,06H - 07H,101,215,114
Vilnius,19,19-S. NERIES GIMNAZIJA,07H - 08H,230,357,127
Vilnius,19,19-S. NERIES GIMNAZIJA,08H - 09H,722,559,-163
Vilnius,19,19-S. NERIES GIMNAZIJA,09H - 10H,677,691,14
Vilnius,19,19-S. NERIES GIMNAZIJA,10H - 11H,320,598,278
Vilnius,19,19-S. NERIES GIMNAZIJA,11H - 12H,342,536,194
Vilnius,19,19-S. NERIES GIMNAZIJA,12H - 13H,567,601,34
Vilnius,19,19-S. NERIES GIMNAZIJA,13H - 14H,643,572,-71
Vilnius,19,19-S. NERIES GIMNAZIJA,14H - 15H,548,537,-11
Vilnius,19,19-S. NERIES GIMNAZIJA,15H - 16H,574,522,-52
Vilnius,19,19-S. NERIES GIMNAZIJA,16H - 17H,744,794,50
Vilnius,19,19-S. NERIES GIMNAZIJA,17H - 18H,1034,975,-59
Vilnius,19,19-S. NERIES GIMNAZIJA,18H - 19H,995,1017,22
Vilnius,19,19-S. NERIES GIMNAZIJA,19H - 20H,628,848,220
Vilnius,19,19-S. NERIES GIMNAZIJA,20H - 21H,638,681,43
Vilnius,19,19-S. NERIES GIMNAZIJA,21H - 22H,550,502,-48
Vilnius,19,19-S. NERIES GIMNAZIJA,22H - 23H,455,312,-143
Vilnius,19,19-S. NERIES GIMNAZIJA,23H - 24H,330,162,-168
Vilnius,20,20-TRAKU,00H - 01H,147,119,-28
Vilnius,20,20-TRAKU,01H - 02H,86,66,-20
Vilnius,20,20-TRAKU,02H - 03H,40,43,3
Vilnius,20,20-TRAKU,03H - 04H,25,22,-3
Vilnius,20,20-TRAKU,04H - 05H,29,22,-7
Vilnius,20,20-TRAKU,05H - 06H,44,18,-26
Vilnius,20,20-TRAKU,06H - 07H,51,433,382
Vilnius,20,20-TRAKU,07H - 08H,731,776,45
Vilnius,20,20-TRAKU,08H - 09H,1457,904,-553
Vilnius,20,20-TRAKU,09H - 10H,772,818,46
Vilnius,20,20-TRAKU,10H - 11H,470,476,6
Vilnius,20,20-TRAKU,11H - 12H,396,498,102
Vilnius,20,20-TRAKU,12H - 13H,620,519,-101
Vilnius,20,20-TRAKU,13H - 14H,599,532,-67
Vilnius,20,20-TRAKU,14H - 15H,585,494,-91
Vilnius,20,20-TRAKU,15H - 16H,500,597,97
Vilnius,20,20-TRAKU,16H - 17H,835,794,-41
Vilnius,20,20-TRAKU,17H - 18H,938,1273,335
Vilnius,20,20-TRAKU,18H - 19H,1179,1030,-149
Vilnius,20,20-TRAKU,19H - 20H,735,709,-26
Vilnius,20,20-TRAKU,20H - 21H,598,629,31
Vilnius,20,20-TRAKU,21H - 22H,444,509,65
Vilnius,20,20-TRAKU,22H - 23H,300,303,3
Vilnius,20,20-TRAKU,23H - 24H,223,208,-15
Vilnius,21,21-VAŠINGTONO A.,00H - 01H,34,55,21
Vilnius,21,21-VAŠINGTONO A.,01H - 02H,28,26,-2
Vilnius,21,21-VAŠINGTONO A.,02H - 03H,9,14,5
Vilnius,21,21-VAŠINGTONO A.,03H - 04H,15,22,7
Vilnius,21,21-VAŠINGTONO A.,04H - 05H,4,8,4
Vilnius,21,21-VAŠINGTONO A.,05H - 06H,7,9,2
Vilnius,21,21-VAŠINGTONO A.,06H - 07H,302,38,-264
Vilnius,21,21-VAŠINGTONO A.,07H - 08H,327,484,157
Vilnius,21,21-VAŠINGTONO A.,08H - 09H,795,999,204
Vilnius,21,21-VAŠINGTONO A.,09H - 10H,483,567,84
Vilnius,21,21-VAŠINGTONO A.,10H - 11H,409,340,-69
Vilnius,21,21-VAŠINGTONO A.,11H - 12H,458,400,-58
Vilnius,21,21-VAŠINGTONO A.,12H - 13H,665,611,-54
Vilnius,21,21-VAŠINGTONO A.,13H - 14H,463,459,-4
Vilnius,21,21-VAŠINGTONO A.,14H - 15H,318,342,24
Vilnius,21,21-VAŠINGTONO A.,15H - 16H,408,393,-15
Vilnius,21,21-VAŠINGTONO A.,16H - 17H,661,511,-150
Vilnius,21,21-VAŠINGTONO A.,17H - 18H,937,837,-100
Vilnius,21,21-VAŠINGTONO A.,18H - 19H,648,577,-71
Vilnius,21,21-VAŠINGTONO A.,19H - 20H,458,500,42
Vilnius,21,21-VAŠINGTONO A.,20H - 21H,306,424,118
Vilnius,21,21-VAŠINGTONO A.,21H - 22H,259,303,44
Vilnius,21,21-VAŠINGTONO A.,22H - 23H,133,195,62
Vilnius,21,21-VAŠINGTONO A.,23H - 24H,68,86,18
Vilnius,22,22-VCUP,00H - 01H,77,72,-5
Vilnius,22,22-VCUP,01H - 02H,41,52,11
Vilnius,22,22-VCUP,02H - 03H,21,26,5
Vilnius,22,22-VCUP,03H - 04H,14,17,3
Vilnius,22,22-VCUP,04H - 05H,5,13,8
Vilnius,22,22-VCUP,05H - 06H,12,28,16
Vilnius,22,22-VCUP,06H - 07H,332,85,-247
Vilnius,22,22-VCUP,07H - 08H,543,537,-6
Vilnius,22,22-VCUP,08H - 09H,681,1166,485
Vilnius,22,22-VCUP,09H - 10H,606,653,47
Vilnius,22,22-VCUP,10H - 11H,602,469,-133
Vilnius,22,22-VCUP,11H - 12H,699,792,93
Vilnius,22,22-VCUP,12H - 13H,1084,1145,61
Vilnius,22,22-VCUP,13H - 14H,881,833,-48
Vilnius,22,22-VCUP,14H - 15H,906,829,-77
Vilnius,22,22-VCUP,15H - 16H,1016,890,-126
Vilnius,22,22-VCUP,16H - 17H,1093,1015,-78
Vilnius,22,22-VCUP,17H - 18H,1443,1451,8
Vilnius,22,22-VCUP,18H - 19H,1384,1566,182
Vilnius,22,22-VCUP,19H - 20H,1285,1245,-40
Vilnius,22,22-VCUP,20H - 21H,992,1025,33
Vilnius,22,22-VCUP,21H - 22H,752,658,-94
Vilnius,22,22-VCUP,22H - 23H,388,314,-74
Vilnius,22,22-VCUP,23H - 24H,142,146,4
Vilnius,23,23-EUROPOS A.,00H - 01H,45,63,18
Vilnius,23,23-EUROPOS A.,01H - 02H,30,37,7
Vilnius,23,23-EUROPOS A.,02H - 03H,14,22,8
Vilnius,23,23-EUROPOS A.,03H - 04H,6,8,2
Vilnius,23,23-EUROPOS A.,04H - 05H,2,7,5
Vilnius,23,23-EUROPOS A.,05H - 06H,11,12,1
Vilnius,23,23-EUROPOS A.,06H - 07H,207,118,-89
Vilnius,23,23-EUROPOS A.,07H - 08H,360,429,69
Vilnius,23,23-EUROPOS A.,08H - 09H,789,1245,456
Vilnius,23,23-EUROPOS A.,09H - 10H,601,783,182
Vilnius,23,23-EUROPOS A.,10H - 11H,418,365,-53
Vilnius,23,23-EUROPOS A.,11H - 12H,672,465,-207
Vilnius,23,23-EUROPOS A.,12H - 13H,728,615,-113
Vilnius,23,23-EUROPOS A.,13H - 14H,588,601,13
Vilnius,23,23-EUROPOS A.,14H - 15H,543,702,159
Vilnius,23,23-EUROPOS A.,15H - 16H,634,924,290
Vilnius,23,23-EUROPOS A.,16H - 17H,855,715,-140
Vilnius,23,23-EUROPOS A.,17H - 18H,1585,941,-644
Vilnius,23,23-EUROPOS A.,18H - 19H,1138,1149,11
Vilnius,23,23-EUROPOS A.,19H - 20H,666,771,105
Vilnius,23,23-EUROPOS A.,20H - 21H,545,532,-13
Vilnius,23,23-EUROPOS A.,21H - 22H,476,270,-206
Vilnius,23,23-EUROPOS A.,22H - 23H,143,215,72
Vilnius,23,23-EUROPOS A.,23H - 24H,108,165,57
Vilnius,24,24-FORUM PALACE,00H - 01H,10,27,17
Vilnius,24,24-FORUM PALACE,01H - 02H,9,9,0
Vilnius,24,24-FORUM PALACE,02H - 03H,2,7,5
Vilnius,24,24-FORUM PALACE,03H - 04H,3,9,6
Vilnius,24,24-FORUM PALACE,04H - 05H,1,3,2
Vilnius,24,24-FORUM PALACE,05H - 06H,1,5,4
Vilnius,24,24-FORUM PALACE,06H - 07H,112,41,-71
Vilnius,24,24-FORUM PALACE,07H - 08H,221,61,-160
Vilnius,24,24-FORUM PALACE,08H - 09H,322,523,201
Vilnius,24,24-FORUM PALACE,09H - 10H,376,514,138
Vilnius,24,24-FORUM PALACE,10H - 11H,213,162,-51
Vilnius,24,24-FORUM PALACE,11H - 12H,257,171,-86
Vilnius,24,24-FORUM PALACE,12H - 13H,275,246,-29
Vilnius,24,24-FORUM PALACE,13H - 14H,273,299,26
Vilnius,24,24-FORUM PALACE,14H - 15H,285,246,-39
Vilnius,24,24-FORUM PALACE,15H - 16H,230,239,9
Vilnius,24,24-FORUM PALACE,16H - 17H,217,367,150
Vilnius,24,24-FORUM PALACE,17H - 18H,470,384,-86
Vilnius,24,24-FORUM PALACE,18H - 19H,664,486,-178
Vilnius,24,24-FORUM PALACE,19H - 20H,294,339,45
Vilnius,24,24-FORUM PALACE,20H - 21H,218,252,34
Vilnius,24,24-FORUM PALACE,21H - 22H,108,154,46
Vilnius,24,24-FORUM PALACE,22H - 23H,68,81,13
Vilnius,24,24-FORUM PALACE,23H - 24H,22,32,10
Vilnius,25,25-PANORAMA,00H - 01H,22,104,82
Vilnius,25,25-PANORAMA,01H - 02H,8,61,53
Vilnius,25,25-PANORAMA,02H - 03H,10,41,31
Vilnius,25,25-PANORAMA,03H - 04H,11,47,36
Vilnius,25,25-PANORAMA,04H - 05H,4,20,16
Vilnius,25,25-PANORAMA,05H - 06H,5,18,13
Vilnius,25,25-PANORAMA,06H - 07H,104,121,17
Vilnius,25,25-PANORAMA,07H - 08H,371,147,-224
Vilnius,25,25-PANORAMA,08H - 09H,515,233,-282
Vilnius,25,25-PANORAMA,09H - 10H,365,297,-68
Vilnius,25,25-PANORAMA,10H - 11H,229,287,58
Vilnius,25,25-PANORAMA,11H - 12H,320,219,-101
Vilnius,25,25-PANORAMA,12H - 13H,343,484,141
Vilnius,25,25-PANORAMA,13H - 14H,345,411,66
Vilnius,25,25-PANORAMA,14H - 15H,328,335,7
Vilnius,25,25-PANORAMA,15H - 16H,362,347,-15
Vilnius,25,25-PANORAMA,16H - 17H,406,498,92
Vilnius,25,25-PANORAMA,17H - 18H,663,804,141
Vilnius,25,25-PANORAMA,18H - 19H,731,664,-67
Vilnius,25,25-PANORAMA,19H - 20H,537,458,-79
Vilnius,25,25-PANORAMA,20H - 21H,441,449,8
Vilnius,25,25-PANORAMA,21H - 22H,287,328,41
Vilnius,25,25-PANORAMA,22H - 23H,224,206,-18
Vilnius,25,25-PANORAMA,23H - 24H,60,116,56
Vilnius,26,26-EDUKOLOGIJOS UNIVERSITETAS,00H - 01H,35,140,105
Vilnius,26,26-EDUKOLOGIJOS UNIVERSITETAS,01H - 02H,10,87,77
Vilnius,26,26-EDUKOLOGIJOS UNIVERSITETAS,02H - 03H,8,63,55
Vilnius,26,26-EDUKOLOGIJOS UNIVERSITETAS,03H - 04H,1,38,37
Vilnius,26,26-EDUKOLOGIJOS UNIVERSITETAS,04H - 05H,2,19,17
Vilnius,26,26-EDUKOLOGIJOS UNIVERSITETAS,05H - 06H,3,12,9
Vilnius,26,26-EDUKOLOGIJOS UNIVERSITETAS,06H - 07H,152,51,-101
Vilnius,26,26-EDUKOLOGIJOS UNIVERSITETAS,07H - 08H,599,232,-367
Vilnius,26,26-EDUKOLOGIJOS UNIVERSITETAS,08H - 09H,993,546,-447
Vilnius,26,26-EDUKOLOGIJOS UNIVERSITETAS,09H - 10H,565,514,-51
Vilnius,26,26-EDUKOLOGIJOS UNIVERSITETAS,10H - 11H,354,264,-90
Vilnius,26,26-EDUKOLOGIJOS UNIVERSITETAS,11H - 12H,409,269,-140
Vilnius,26,26-EDUKOLOGIJOS UNIVERSITETAS,12H - 13H,547,462,-85
Vilnius,26,26-EDUKOLOGIJOS UNIVERSITETAS,13H - 14H,418,590,172
Vilnius,26,26-EDUKOLOGIJOS UNIVERSITETAS,14H - 15H,424,418,-6
Vilnius,26,26-EDUKOLOGIJOS UNIVERSITETAS,15H - 16H,400,474,74
Vilnius,26,26-EDUKOLOGIJOS UNIVERSITETAS,16H - 17H,544,705,161
Vilnius,26,26-EDUKOLOGIJOS UNIVERSITETAS,17H - 18H,882,964,82
Vilnius,26,26-EDUKOLOGIJOS UNIVERSITETAS,18H - 19H,1006,873,-133
Vilnius,26,26-EDUKOLOGIJOS UNIVERSITETAS,19H - 20H,653,613,-40
Vilnius,26,26-EDUKOLOGIJOS UNIVERSITETAS,20H - 21H,463,537,74
Vilnius,26,26-EDUKOLOGIJOS UNIVERSITETAS,21H - 22H,316,523,207
Vilnius,26,26-EDUKOLOGIJOS UNIVERSITETAS,22H - 23H,143,369,226
Vilnius,26,26-EDUKOLOGIJOS UNIVERSITETAS,23H - 24H,81,224,143
Vilnius,27,27-ŽALIASIS TILTAS,00H - 01H,38,100,62
Vilnius,27,27-ŽALIASIS TILTAS,01H - 02H,11,50,39
Vilnius,27,27-ŽALIASIS TILTAS,02H - 03H,8,26,18
Vilnius,27,27-ŽALIASIS TILTAS,03H - 04H,11,11,0
Vilnius,27,27-ŽALIASIS TILTAS,04H - 05H,5,8,3
Vilnius,27,27-ŽALIASIS TILTAS,05H - 06H,6,18,12
Vilnius,27,27-ŽALIASIS TILTAS,06H - 07H,96,104,8
Vilnius,27,27-ŽALIASIS TILTAS,07H - 08H,815,358,-457
Vilnius,27,27-ŽALIASIS TILTAS,08H - 09H,735,656,-79
Vilnius,27,27-ŽALIASIS TILTAS,09H - 10H,604,617,13
Vilnius,27,27-ŽALIASIS TILTAS,10H - 11H,365,416,51
Vilnius,27,27-ŽALIASIS TILTAS,11H - 12H,345,407,62
Vilnius,27,27-ŽALIASIS TILTAS,12H - 13H,402,465,63
Vilnius,27,27-ŽALIASIS TILTAS,13H - 14H,387,409,22
Vilnius,27,27-ŽALIASIS TILTAS,14H - 15H,431,418,-13
Vilnius,27,27-ŽALIASIS TILTAS,15H - 16H,411,511,100
Vilnius,27,27-ŽALIASIS TILTAS,16H - 17H,507,605,98
Vilnius,27,27-ŽALIASIS TILTAS,17H - 18H,835,719,-116
Vilnius,27,27-ŽALIASIS TILTAS,18H - 19H,686,809,123
Vilnius,27,27-ŽALIASIS TILTAS,19H - 20H,516,497,-19
Vilnius,27,27-ŽALIASIS TILTAS,20H - 21H,455,409,-46
Vilnius,27,27-ŽALIASIS TILTAS,21H - 22H,315,304,-11
Vilnius,27,27-ŽALIASIS TILTAS,22H - 23H,233,247,14
Vilnius,27,27-ŽALIASIS TILTAS,23H - 24H,102,155,53
Vilnius,28,28-OPEROS IR BALETO TEATRAS,00H - 01H,24,52,28
Vilnius,28,28-OPEROS IR BALETO TEATRAS,01H - 02H,17,28,11
Vilnius,28,28-OPEROS IR BALETO TEATRAS,02H - 03H,9,14,5
Vilnius,28,28-OPEROS IR BALETO TEATRAS,03H - 04H,10,8,-2
Vilnius,28,28-OPEROS IR BALETO TEATRAS,04H - 05H,9,11,2
Vilnius,28,28-OPEROS IR BALETO TEATRAS,05H - 06H,3,3,0
Vilnius,28,28-OPEROS IR BALETO TEATRAS,06H - 07H,103,11,-92
Vilnius,28,28-OPEROS IR BALETO TEATRAS,07H - 08H,136,83,-53
Vilnius,28,28-OPEROS IR BALETO TEATRAS,08H - 09H,262,167,-95
Vilnius,28,28-OPEROS IR BALETO TEATRAS,09H - 10H,219,272,53
Vilnius,28,28-OPEROS IR BALETO TEATRAS,10H - 11H,162,181,19
Vilnius,28,28-OPEROS IR BALETO TEATRAS,11H - 12H,163,157,-6
Vilnius,28,28-OPEROS IR BALETO TEATRAS,12H - 13H,198,210,12
Vilnius,28,28-OPEROS IR BALETO TEATRAS,13H - 14H,200,202,2
Vilnius,28,28-OPEROS IR BALETO TEATRAS,14H - 15H,191,202,11
Vilnius,28,28-OPEROS IR BALETO TEATRAS,15H - 16H,156,201,45
Vilnius,28,28-OPEROS IR BALETO TEATRAS,16H - 17H,184,258,74
Vilnius,28,28-OPEROS IR BALETO TEATRAS,17H - 18H,326,370,44
Vilnius,28,28-OPEROS IR BALETO TEATRAS,18H - 19H,397,318,-79
Vilnius,28,28-OPEROS IR BALETO TEATRAS,19H - 20H,247,232,-15
Vilnius,28,28-OPEROS IR BALETO TEATRAS,20H - 21H,205,228,23
Vilnius,28,28-OPEROS IR BALETO TEATRAS,21H - 22H,167,162,-5
Vilnius,28,28-OPEROS IR BALETO TEATRAS,22H - 23H,101,85,-16
Vilnius,28,28-OPEROS IR BALETO TEATRAS,23H - 24H,49,77,28
Vilnius,29,29-ŽALGIRIO STADIONAS,00H - 01H,20,90,70
Vilnius,29,29-ŽALGIRIO STADIONAS,01H - 02H,12,54,42
Vilnius,29,29-ŽALGIRIO STADIONAS,02H - 03H,8,52,44
Vilnius,29,29-ŽALGIRIO STADIONAS,03H - 04H,2,17,15
Vilnius,29,29-ŽALGIRIO STADIONAS,04H - 05H,4,31,27
Vilnius,29,29-ŽALGIRIO STADIONAS,05H - 06H,7,6,-1
Vilnius,29,29-ŽALGIRIO STADIONAS,06H - 07H,105,77,-28
Vilnius,29,29-ŽALGIRIO STADIONAS,07H - 08H,631,407,-224
Vilnius,29,29-ŽALGIRIO STADIONAS,08H - 09H,746,516,-230
Vilnius,29,29-ŽALGIRIO STADIONAS,09H - 10H,417,380,-37
Vilnius,29,29-ŽALGIRIO STADIONAS,10H - 11H,291,246,-45
Vilnius,29,29-ŽALGIRIO STADIONAS,11H - 12H,486,302,-184
Vilnius,29,29-ŽALGIRIO STADIONAS,12H - 13H,448,615,167
Vilnius,29,29-ŽALGIRIO STADIONAS,13H - 14H,358,362,4
Vilnius,29,29-ŽALGIRIO STADIONAS,14H - 15H,272,305,33
Vilnius,29,29-ŽALGIRIO STADIONAS,15H - 16H,380,341,-39
Vilnius,29,29-ŽALGIRIO STADIONAS,16H - 17H,575,535,-40
Vilnius,29,29-ŽALGIRIO STADIONAS,17H - 18H,787,782,-5
Vilnius,29,29-ŽALGIRIO STADIONAS,18H - 19H,762,792,30
Vilnius,29,29-ŽALGIRIO STADIONAS,19H - 20H,482,561,79
Vilnius,29,29-ŽALGIRIO STADIONAS,20H - 21H,416,439,23
Vilnius,29,29-ŽALGIRIO STADIONAS,21H - 22H,265,324,59
Vilnius,29,29-ŽALGIRIO STADIONAS,22H - 23H,115,257,142
Vilnius,29,29-ŽALGIRIO STADIONAS,23H - 24H,53,154,101
Vilnius,30,30-IKI MINSKAS,00H - 01H,49,165,116
Vilnius,30,30-IKI MINSKAS,01H - 02H,24,103,79
Vilnius,30,30-IKI MINSKAS,02H - 03H,9,48,39
Vilnius,30,30-IKI MINSKAS,03H - 04H,4,38,34
Vilnius,30,30-IKI MINSKAS,04H - 05H,7,29,22
Vilnius,30,30-IKI MINSKAS,05H - 06H,16,20,4
Vilnius,30,30-IKI MINSKAS,06H - 07H,270,242,-28
Vilnius,30,30-IKI MINSKAS,07H - 08H,1203,261,-942
Vilnius,30,30-IKI MINSKAS,08H - 09H,1217,604,-613
Vilnius,30,30-IKI MINSKAS,09H - 10H,614,608,-6
Vilnius,30,30-IKI MINSKAS,10H - 11H,434,366,-68
Vilnius,30,30-IKI MINSKAS,11H - 12H,346,340,-6
Vilnius,30,30-IKI MINSKAS,12H - 13H,371,346,-25
Vilnius,30,30-IKI MINSKAS,13H - 14H,370,371,1
Vilnius,30,30-IKI MINSKAS,14H - 15H,510,413,-97
Vilnius,30,30-IKI MINSKAS,15H - 16H,624,581,-43
Vilnius,30,30-IKI MINSKAS,16H - 17H,738,948,210
Vilnius,30,30-IKI MINSKAS,17H - 18H,1119,1794,675
Vilnius,30,30-IKI MINSKAS,18H - 19H,1395,1433,38
Vilnius,30,30-IKI MINSKAS,19H - 20H,966,972,6
Vilnius,30,30-IKI MINSKAS,20H - 21H,942,918,-24
Vilnius,30,30-IKI MINSKAS,21H - 22H,467,716,249
Vilnius,30,30-IKI MINSKAS,22H - 23H,215,432,217
Vilnius,30,30-IKI MINSKAS,23H - 24H,73,217,144
Vilnius,31,31-OLANDU ŽIEDAS,00H - 01H,29,121,92
Vilnius,31,31-OLANDU ŽIEDAS,01H - 02H,18,90,72
Vilnius,31,31-OLANDU ŽIEDAS,02H - 03H,11,58,47
Vilnius,31,31-OLANDU ŽIEDAS,03H - 04H,2,29,27
Vilnius,31,31-OLANDU ŽIEDAS,04H - 05H,2,29,27
Vilnius,31,31-OLANDU ŽIEDAS,05H - 06H,15,16,1
Vilnius,31,31-OLANDU ŽIEDAS,06H - 07H,102,225,123
Vilnius,31,31-OLANDU ŽIEDAS,07H - 08H,1017,257,-760
Vilnius,31,31-OLANDU ŽIEDAS,08H - 09H,1441,511,-930
Vilnius,31,31-OLANDU ŽIEDAS,09H - 10H,605,684,79
Vilnius,31,31-OLANDU ŽIEDAS,10H - 11H,368,425,57
Vilnius,31,31-OLANDU ŽIEDAS,11H - 12H,347,269,-78
Vilnius,31,31-OLANDU ŽIEDAS,12H - 13H,418,312,-106
Vilnius,31,31-OLANDU ŽIEDAS,13H - 14H,352,354,2
Vilnius,31,31-OLANDU ŽIEDAS,14H - 15H,404,383,-21
Vilnius,31,31-OLANDU ŽIEDAS,15H - 16H,455,400,-55
Vilnius,31,31-OLANDU ŽIEDAS,16H - 17H,576,568,-8
Vilnius,31,31-OLANDU ŽIEDAS,17H - 18H,633,1239,606
Vilnius,31,31-OLANDU ŽIEDAS,18H - 19H,756,1009,253
Vilnius,31,31-OLANDU ŽIEDAS,19H - 20H,603,608,5
Vilnius,31,31-OLANDU ŽIEDAS,20H - 21H,481,514,33
Vilnius,31,31-OLANDU ŽIEDAS,21H - 22H,295,471,176
Vilnius,31,31-OLANDU ŽIEDAS,22H - 23H,109,309,200
Vilnius,31,31-OLANDU ŽIEDAS,23H - 24H,64,220,156
Vilnius,33,33-LIETUVOS VAIKU IR JAUNIMO CENTRAS,00H - 01H,23,36,13
Vilnius,33,33-LIETUVOS VAIKU IR JAUNIMO CENTRAS,01H - 02H,6,32,26
Vilnius,33,33-LIETUVOS VAIKU IR JAUNIMO CENTRAS,02H - 03H,5,14,9
Vilnius,33,33-LIETUVOS VAIKU IR JAUNIMO CENTRAS,03H - 04H,2,7,5
Vilnius,33,33-LIETUVOS VAIKU IR JAUNIMO CENTRAS,04H - 05H,5,6,1
Vilnius,33,33-LIETUVOS VAIKU IR JAUNIMO CENTRAS,05H - 06H,1,14,13
Vilnius,33,33-LIETUVOS VAIKU IR JAUNIMO CENTRAS,06H - 07H,90,54,-36
Vilnius,33,33-LIETUVOS VAIKU IR JAUNIMO CENTRAS,07H - 08H,156,104,-52
Vilnius,33,33-LIETUVOS VAIKU IR JAUNIMO CENTRAS,08H - 09H,305,282,-23
Vilnius,33,33-LIETUVOS VAIKU IR JAUNIMO CENTRAS,09H - 10H,254,210,-44
Vilnius,33,33-LIETUVOS VAIKU IR JAUNIMO CENTRAS,10H - 11H,191,152,-39
Vilnius,33,33-LIETUVOS VAIKU IR JAUNIMO CENTRAS,11H - 12H,211,237,26
Vilnius,33,33-LIETUVOS VAIKU IR JAUNIMO CENTRAS,12H - 13H,300,243,-57
Vilnius,33,33-LIETUVOS VAIKU IR JAUNIMO CENTRAS,13H - 14H,231,193,-38
Vilnius,33,33-LIETUVOS VAIKU IR JAUNIMO CENTRAS,14H - 15H,175,233,58
Vilnius,33,33-LIETUVOS VAIKU IR JAUNIMO CENTRAS,15H - 16H,175,229,54
Vilnius,33,33-LIETUVOS VAIKU IR JAUNIMO CENTRAS,16H - 17H,258,286,28
Vilnius,33,33-LIETUVOS VAIKU IR JAUNIMO CENTRAS,17H - 18H,477,440,-37
Vilnius,33,33-LIETUVOS VAIKU IR JAUNIMO CENTRAS,18H - 19H,350,346,-4
Vilnius,33,33-LIETUVOS VAIKU IR JAUNIMO CENTRAS,19H - 20H,331,344,13
Vilnius,33,33-LIETUVOS VAIKU IR JAUNIMO CENTRAS,20H - 21H,227,244,17
Vilnius,33,33-LIETUVOS VAIKU IR JAUNIMO CENTRAS,21H - 22H,143,140,-3
Vilnius,33,33-LIETUVOS VAIKU IR JAUNIMO CENTRAS,22H - 23H,76,122,46
Vilnius,33,33-LIETUVOS VAIKU IR JAUNIMO CENTRAS,23H - 24H,39,65,26
Vilnius,35,35-VILNIAUS VARTAI,00H - 01H,36,25,-11
Vilnius,35,35-VILNIAUS VARTAI,01H - 02H,24,13,-11
Vilnius,35,35-VILNIAUS VARTAI,02H - 03H,16,4,-12
Vilnius,35,35-VILNIAUS VARTAI,03H - 04H,15,4,-11
Vilnius,35,35-VILNIAUS VARTAI,04H - 05H,8,1,-7
Vilnius,35,35-VILNIAUS VARTAI,05H - 06H,0,1,1
Vilnius,35,35-VILNIAUS VARTAI,06H - 07H,178,5,-173
Vilnius,35,35-VILNIAUS VARTAI,07H - 08H,210,407,197
Vilnius,35,35-VILNIAUS VARTAI,08H - 09H,286,705,419
Vilnius,35,35-VILNIAUS VARTAI,09H - 10H,260,463,203
Vilnius,35,35-VILNIAUS VARTAI,10H - 11H,222,177,-45
Vilnius,35,35-VILNIAUS VARTAI,11H - 12H,427,187,-240
Vilnius,35,35-VILNIAUS VARTAI,12H - 13H,451,326,-125
Vilnius,35,35-VILNIAUS VARTAI,13H - 14H,263,486,223
Vilnius,35,35-VILNIAUS VARTAI,14H - 15H,198,187,-11
Vilnius,35,35-VILNIAUS VARTAI,15H - 16H,262,225,-37
Vilnius,35,35-VILNIAUS VARTAI,16H - 17H,458,293,-165
Vilnius,35,35-VILNIAUS VARTAI,17H - 18H,624,328,-296
Vilnius,35,35-VILNIAUS VARTAI,18H - 19H,465,422,-43
Vilnius,35,35-VILNIAUS VARTAI,19H - 20H,201,259,58
Vilnius,35,35-VILNIAUS VARTAI,20H - 21H,161,210,49
Vilnius,35,35-VILNIAUS VARTAI,21H - 22H,88,136,48
Vilnius,35,35-VILNIAUS VARTAI,22H - 23H,57,63,6
Vilnius,35,35-VILNIAUS VARTAI,23H - 24H,40,31,-9
Vilnius,36,36-AUTOBUSU STOTIS,00H - 01H,27,45,18
Vilnius,36,36-AUTOBUSU STOTIS,01H - 02H,12,22,10
Vilnius,36,36-AUTOBUSU STOTIS,02H - 03H,8,18,10
Vilnius,36,36-AUTOBUSU STOTIS,03H - 04H,3,9,6
Vilnius,36,36-AUTOBUSU STOTIS,04H - 05H,1,11,10
Vilnius,36,36-AUTOBUSU STOTIS,05H - 06H,9,4,-5
Vilnius,36,36-AUTOBUSU STOTIS,06H - 07H,90,245,155
Vilnius,36,36-AUTOBUSU STOTIS,07H - 08H,423,222,-201
Vilnius,36,36-AUTOBUSU STOTIS,08H - 09H,384,248,-136
Vilnius,36,36-AUTOBUSU STOTIS,09H - 10H,208,189,-19
Vilnius,36,36-AUTOBUSU STOTIS,10H - 11H,127,145,18
Vilnius,36,36-AUTOBUSU STOTIS,11H - 12H,132,182,50
Vilnius,36,36-AUTOBUSU STOTIS,12H - 13H,144,126,-18
Vilnius,36,36-AUTOBUSU STOTIS,13H - 14H,175,116,-59
Vilnius,36,36-AUTOBUSU STOTIS,14H - 15H,168,196,28
Vilnius,36,36-AUTOBUSU STOTIS,15H - 16H,190,175,-15
Vilnius,36,36-AUTOBUSU STOTIS,16H - 17H,196,190,-6
Vilnius,36,36-AUTOBUSU STOTIS,17H - 18H,231,279,48
Vilnius,36,36-AUTOBUSU STOTIS,18H - 19H,182,224,42
Vilnius,36,36-AUTOBUSU STOTIS,19H - 20H,214,175,-39
Vilnius,36,36-AUTOBUSU STOTIS,20H - 21H,139,168,29
Vilnius,36,36-AUTOBUSU STOTIS,21H - 22H,94,139,45
Vilnius,36,36-AUTOBUSU STOTIS,22H - 23H,79,73,-6
Vilnius,36,36-AUTOBUSU STOTIS,23H - 24H,37,73,36
Vilnius,38,38-ŠILO TILTAS,00H - 01H,27,78,51
Vilnius,38,38-ŠILO TILTAS,01H - 02H,13,61,48
Vilnius,38,38-ŠILO TILTAS,02H - 03H,13,28,15
Vilnius,38,38-ŠILO TILTAS,03H - 04H,8,38,30
Vilnius,38,38-ŠILO TILTAS,04H - 05H,4,16,12
Vilnius,38,38-ŠILO TILTAS,05H - 06H,9,12,3
Vilnius,38,38-ŠILO TILTAS,06H - 07H,181,105,-76
Vilnius,38,38-ŠILO TILTAS,07H - 08H,972,337,-635
Vilnius,38,38-ŠILO TILTAS,08H - 09H,649,444,-205
Vilnius,38,38-ŠILO TILTAS,09H - 10H,442,337,-105
Vilnius,38,38-ŠILO TILTAS,10H - 11H,281,287,6
Vilnius,38,38-ŠILO TILTAS,11H - 12H,310,263,-47
Vilnius,38,38-ŠILO TILTAS,12H - 13H,378,409,31
Vilnius,38,38-ŠILO TILTAS,13H - 14H,338,351,13
Vilnius,38,38-ŠILO TILTAS,14H - 15H,450,378,-72
Vilnius,38,38-ŠILO TILTAS,15H - 16H,520,446,-74
Vilnius,38,38-ŠILO TILTAS,16H - 17H,591,749,158
Vilnius,38,38-ŠILO TILTAS,17H - 18H,964,1315,351
Vilnius,38,38-ŠILO TILTAS,18H - 19H,1083,1012,-71
Vilnius,38,38-ŠILO TILTAS,19H - 20H,838,736,-102
Vilnius,38,38-ŠILO TILTAS,20H - 21H,577,749,172
Vilnius,38,38-ŠILO TILTAS,21H - 22H,331,534,203
Vilnius,38,38-ŠILO TILTAS,22H - 23H,126,312,186
Vilnius,38,38-ŠILO TILTAS,23H - 24H,52,159,107
Vilnius,39,39-ŠIAURES MIESTELIS,00H - 01H,31,86,55
Vilnius,39,39-ŠIAURES MIESTELIS,01H - 02H,11,67,56
Vilnius,39,39-ŠIAURES MIESTELIS,02H - 03H,9,39,30
Vilnius,39,39-ŠIAURES MIESTELIS,03H - 04H,4,39,35
Vilnius,39,39-ŠIAURES MIESTELIS,04H - 05H,3,25,22
Vilnius,39,39-ŠIAURES MIESTELIS,05H - 06H,3,10,7
Vilnius,39,39-ŠIAURES MIESTELIS,06H - 07H,100,403,303
Vilnius,39,39-ŠIAURES MIESTELIS,07H - 08H,882,279,-603
Vilnius,39,39-ŠIAURES MIESTELIS,08H - 09H,634,442,-192
Vilnius,39,39-ŠIAURES MIESTELIS,09H - 10H,232,432,200
Vilnius,39,39-ŠIAURES MIESTELIS,10H - 11H,198,206,8
Vilnius,39,39-ŠIAURES MIESTELIS,11H - 12H,258,178,-80
Vilnius,39,39-ŠIAURES MIESTELIS,12H - 13H,265,199,-66
Vilnius,39,39-ŠIAURES MIESTELIS,13H - 14H,256,233,-23
Vilnius,39,39-ŠIAURES MIESTELIS,14H - 15H,243,275,32
Vilnius,39,39-ŠIAURES MIESTELIS,15H - 16H,312,297,-15
Vilnius,39,39-ŠIAURES MIESTELIS,16H - 17H,424,367,-57
Vilnius,39,39-ŠIAURES MIESTELIS,17H - 18H,675,753,78
Vilnius,39,39-ŠIAURES MIESTELIS,18H - 19H,615,704,89
Vilnius,39,39-ŠIAURES MIESTELIS,19H - 20H,510,460,-50
Vilnius,39,39-ŠIAURES MIESTELIS,20H - 21H,418,396,-22
Vilnius,39,39-ŠIAURES MIESTELIS,21H - 22H,247,241,-6
Vilnius,39,39-ŠIAURES MIESTELIS,22H - 23H,100,221,121
Vilnius,39,39-ŠIAURES MIESTELIS,23H - 24H,54,136,82
Vilnius,40,40-OGMIOS MIESTAS,00H - 01H,13,38,25
Vilnius,40,40-OGMIOS MIESTAS,01H - 02H,7,16,9
Vilnius,40,40-OGMIOS MIESTAS,02H - 03H,3,10,7
Vilnius,40,40-OGMIOS MIESTAS,03H - 04H,1,12,11
Vilnius,40,40-OGMIOS MIESTAS,04H - 05H,1,4,3
Vilnius,40,40-OGMIOS MIESTAS,05H - 06H,3,3,0
Vilnius,40,40-OGMIOS MIESTAS,06H - 07H,30,67,37
Vilnius,40,40-OGMIOS MIESTAS,07H - 08H,97,66,-31
Vilnius,40,40-OGMIOS MIESTAS,08H - 09H,260,150,-110
Vilnius,40,40-OGMIOS MIESTAS,09H - 10H,73,92,19
Vilnius,40,40-OGMIOS MIESTAS,10H - 11H,52,103,51
Vilnius,40,40-OGMIOS MIESTAS,11H - 12H,90,116,26
Vilnius,40,40-OGMIOS MIESTAS,12H - 13H,104,106,2
Vilnius,40,40-OGMIOS MIESTAS,13H - 14H,90,71,-19
Vilnius,40,40-OGMIOS MIESTAS,14H - 15H,83,102,19
Vilnius,40,40-OGMIOS MIESTAS,15H - 16H,141,109,-32
Vilnius,40,40-OGMIOS MIESTAS,16H - 17H,150,189,39
Vilnius,40,40-OGMIOS MIESTAS,17H - 18H,322,361,39
Vilnius,40,40-OGMIOS MIESTAS,18H - 19H,284,246,-38
Vilnius,40,40-OGMIOS MIESTAS,19H - 20H,198,161,-37
Vilnius,40,40-OGMIOS MIESTAS,20H - 21H,154,131,-23
Vilnius,40,40-OGMIOS MIESTAS,21H - 22H,92,81,-11
Vilnius,40,40-OGMIOS MIESTAS,22H - 23H,34,39,5
Vilnius,40,40-OGMIOS MIESTAS,23H - 24H,17,33,16